%%%%%%%%%%%%%%%%%%%%%%%%
%                      %
%%%%%%%%%%%%%%%%%%% %%%%
%                      %
%%% %%%%%%%%%%%%%%%%%%%%
%                      %
%%%%%%%%%%%%%%%%%%% %%%%
%                      %
%%% %%%%%%%%%%%%%%%%%%%%
%                      %
%%%%%%%%%%%%%%%%%%% %%%%
%                      %
%%% %%%%%%%%%%%%%%%%%%%%
%                      %
%%%%%%%%%%%%%%%%%%% %%%%
%                      %
%%% %%%%%%%%%%%%%%%%%%%%
%                     P%
%%%%%%%%%%%%%%%%%%%%%%%%
